1111111111
1000000C01
11100000P1
110C000001
1111000111
10010001
111100E111
1111111111
