1111111111
1000000C01
1110000001
110C000001
1111000001
1001000001
111100E001
1111111111
