1111111111
1000000C01
11100000P1
110C000001
1111000001
1001000001
1111000001
1111111111
