1111111111
1000000001
11100000P1
1100000001
1111000001
1001000001
111100E001
1111111111
