1111111111
1000000C01
10010001
111111last
